  #########
### @ #   #
# * $ *.. #
#   $ #   #
####*#  ###
 #     ##
 #   ###
 #####

