##########
# @ .... #
#   ####$##
## #  $ $ #
 # $      #
 #   ######
 #####

