######
#  @ #
#  # ##
# .#  ##
# .$$$ #
# .#   #
####   #
   #####

