####
#  ####
#.*$  #
# .$# #
## @  #
 #   ##
 #####

