#######
#     #####
# $$#@##..#
# #       #
#  $ # #  #
#### $  ..#
   ########

