##########
#        #
# ##.### #
# # $$ . #
# . @$## #
#####    #
    ######

