##########
#   ##   #
# $  $@# #
#### # $ #
   #.#  ##
 # #.# $#
 # #.   #
 # #.   #
   ######

