      ######
      #    #
  ##### .  #
###  ###.  #
# $  $  . ##
# @$$ # . #
##    #####
 ######

