   ###
   #@#
 ###$###
##  .  ##
#  # #  #
# #   # #
# #   # #
# #   # #
#  # #  #
## $ $ ##
 ##. .##
  #   #
  #   #
  #####

