######
#   .#
# ## ##
#  $$@#
# #   #
#.  ###
#####

