 #####
 #   #
 # . #
## * #
#  *##
#  @##
## $ #
 #   #
 #####

