        ####
#########  #
#   ## $   #
#  $   ##  #
### #. .# ##
  # #. .#$##
  # #   #  #
  # @ $    #
  #  #######
  ####

