               #####
               #   #
#######  ####### # #
#     #  #  #      #
#  @  ####  #     ####
#  #    ....## ####  #
#    ##### ## $$ $ $ #
######   #           #
         #  ##########
         ####

