 #########
 #    #  #
## $#$#  #
#  .$.@  #
#  .#    #
##########

