   ####
   #  #
 ###  #
##  $ #
#   # #
# #$$ ######
# #   #   .#
#  $  @   .#
###  ####..#
  ####  ####

