####
#. ##
#.@ #
#. $#
##$ ###
 # $  #
 #    #
 #  ###
 ####

