####
#  ###
# $$ #
#... #
# @$ #
#   ##
#####

