    #####             
    #   #             
    #*  #             
  ###  *###           
  #  *  * #           
### # ### #     ######
#   # ### #######  ..#
# *  *             ..#
##### #### #@####  ..#
    #      ###  ######
    ########          