########
#   #  #
# #.$ $#
#   $  #
#####. #
###   @#
###   .#
########
