########
##  .@ #
## #.# #
##   $ #
##.$$ ##
##  ####
########
########
    