########
#   ####
#  $  ##
##$$ .##
##@ . ##
### # ##
###  .##
########
