########
### .  #
# $@#. #
#  $# ##
#  *  ##
##  # ##
###   ##
########
