########
#   ####
# # *@##
#  *   #
###$   #
###   .#
########
########
