########
########
#  .# @#
# # $  #
# $.#$ #
## .   #
##  ####
########
