########
#. #####
# $#####
#  #####
# .$ @ #
# .$ # #
###    #
########
