########
########
###. ###
# .  ###
#   $$ #
## . $@#
########
########
