########
# @.#  #
# .$ . #
#  #$  #
#  $  ##
###  ###
###  ###
########
