########
########
########
# .  ###
# .# ###
# @$$  #
# $.   #
########
