########
########
#####@ #
##### .#
# $ $ $#
#   .  #
### .  #
########
