########
########
###   ##
### #.##
###  .##
#@ $$ ##
#  .$ ##
########
