########
########
#### . #
# *@ . #
# $ #  #
# #  $ #
#   ####
########
