########
########
####. @#
#  .$  #
# #  ###
# $ $ .#
####   #
########
