########
##@.  ##
# $$* ##
#  #  ##
#  #  .#
#### # #
####   #
########
