########
#   @###
# $# ###
# * $  #
#   ## #
##.  . #
###   ##
########
