########
########
########
##  ####
#     ##
#  #$$@#
#  . *.#
########
