########
########
##.  ###
## # ###
## *$  #
##  $. #
##  @###
########
