########
########
#.  @.##
#  $# ##
# # $. #
#   $# #
####   #
########
