########
#### @##
#  *$ ##
#     ##
## .####
##$ ####
## .####
########
