########
##@    #
#. #   #
# $$$.##
# .#  ##
#  #####
########
########
