########
##@ ####
##  ####
##. ####
# $$. .#
#  $ ###
###  ###
########
