########
#### @##
####   #
#. #$$ #
#     ##
#.  $###
##.  ###
########
