########
#    . #
# $  $@#
#.$.####
#  #####
#  #####
#  #####
########
