########
########
########
###  ###
# .. $.#
#  $$ @#
####   #
########
