########
#.  ####
# #   ##
# . # ##
# $*$ ##
##@ ####
##  ####
########
