########
########
##     #
##.## .#
##*  $@#
##  #$ #
##  #  #
########
