########
#. .####
#.#$$ ##
#   @ ##
# $#  ##
##   ###
########
########
