########
#   @###
# $$####
# $ .  #
## #.# #
#.   # #
#      #
########
