########
#  . ###
#    ###
# #$$. #
#.  ## #
#@$ ## #
###    #
########
