########
##   ###
# $# ###
# . @###
# *   ##
## #$ ##
##.  ###
########
