########
#      #
# #$   #
# $ @#.#
##$#.  #
##    .#
########
########
