########
## @ ###
## .   #
#. $.$ #
##$# ###
##   ###
########
########
