########
#   ####
# $$   #
# .#.  #
#  ## ##
#  ##$##
# @  .##
########
