########
#### @ #
####   #
## $ $##
## $  ##
#.  # ##
#..   ##
########
