########
#####  #
#####$.#
###  . #
###  #.#
# $  $ #
#   #@ #
########
