########
###  . #
## * # #
## .$  #
##  #$##
### @ ##
########
########
