########
##  .@##
##   $.#
####*# #
##     #
#  $  ##
#   ####
########
