########
#      #
# # ##*#
# #@ $ #
#.$ .  #
#####  #
#####  #
########
