########
####@ ##
###  ..#
## $#$##
#   $. #
#  #   #
#    ###
########
