########
#  #####
#  #####
# .*   #
##$    #
## #$###
##. @###
########
