########
########
#.   . #
# # #  #
#@$  $.#
##### $#
#####  #
########
