########
###  ###
###  ###
### .. #
#  $#  #
#  .$$ #
#### @ #
########
