########
##.###.#
## #  .#
## $$ @#
##  $  #
##  #  #
##  ####
########
