########
###  .##
# $ # ##
# *$  ##
# .#@ ##
#    ###
#   ####
########
