########
# ..####
# $    #
#  #$# #
# @ .$ #
########
########
########
