########
####  ##
#### $##
# @$.  #
# ##   #
#   ## #
#   * .#
########
