########
#  .####
# $.. ##
#  ##$##
##  #  #
##$   @#
##  ####
########
