########
##@   ##
###$   #
### .  #
# $ #$##
# .  .##
####  ##
########
