########
# .  ###
#  #@###
#  $ ###
##$#  ##
#   # ##
#. *  ##
########
