########
##   @##
##  #  #
##.  $ #
## $$#.#
####  .#
########
########
