 ####
##  ###
#@$   #
### $ #
 #  ######
 #  $....#
 #  # ####
 ## # #
 # $# #
 #    #
 #  ###
 ####

