#############
#.# @#  #   #
#.#$$   # $ #
#.#  # $#   #
#.# $#  # $##
#.#  # $#  #
#.# $#  # $#
#..  # $   #
#..  #  #  #
############

