  #####
  #   #
  # # #######
  #  *  #   #
  ## ##   # #
  #     #*  #
### # # # ###
#  *#$+   #
# #   ## ##
#   #  *  #
####### # #
      #   #
      #####

